#################################################################
||.............................................................||
||..                                                           ||
||..            ########: ####: ##::: ##: ########::           ||
||..            ##.....::. ##:: ###:: ##: ##.... ##:           ||
||..            ##:::::::: ##:: ####: ##: ##:::: ##:           ||
||..            ######:::: ##:: ## ## ##: ##:  : ##:           ||
||..            ##...::::: ##:: ##. ####: ##:::: ##:           ||
||..            ##:::::::: ##:: ##:. ###: ##:::: ##:           ||
||..            ##:::::::'####: ##::. ##: ########:            ||
||..                                                           ||
||..|%|  |%|   |%|..    %%%%%%%%%%%%%  ......|%|    |%| ..   . ||
||..|%|  |%|   |%|.            ...|%|     %%%%%%    |%| ..   . ||
||..|%|            .           ...|%|               |%| ..     ||
||..|%|  %%%%%%%%%%%%%%        ...|%|%%%%%%%%%%     |%| ..     ||
||...............................................   |%| .....* ||
||  .............................................          ... ||
#################################################################

